1513,5,11,6,3,2,0,0,0,0,0,0,1,0,0,0,1,0,0,0,0,0,0,0,3,0,0,0,0,0,0,0,0,0,0,0,0,0,0,0,20
6,1935,17,0,1,1,0,0,0,0,15,0,3,0,0,0,12,1,0,0,0,0,0,0,0,0,0,0,0,0,0,0,2,2,0,0,0,0,0,0,28
4,12,4247,3,0,1,0,0,0,0,8,0,3,0,0,0,26,4,0,0,0,0,0,0,2,0,0,0,0,0,0,0,0,5,0,0,0,0,0,0,64
6,0,9,1341,2,1,0,0,0,0,0,0,1,0,0,0,1,0,0,0,0,0,0,0,2,0,0,0,0,0,0,0,0,0,0,0,0,0,0,0,13
2,1,1,2,225,0,0,0,0,0,0,0,0,0,0,0,0,0,0,0,0,0,0,0,1,0,0,0,0,0,0,0,0,1,0,0,0,0,0,0,3
4,2,1,2,2,860,0,0,0,0,0,0,0,0,0,0,0,0,0,0,0,0,0,0,0,0,0,0,0,0,0,0,0,0,0,0,0,0,0,0,12
0,0,0,0,0,0,957,1,1,0,0,0,0,2,0,0,0,0,0,1,0,0,0,0,0,0,4,0,0,0,1,0,0,0,2,1,0,0,0,0,22
0,0,0,0,0,0,0,263,0,0,0,0,0,0,0,0,0,0,0,0,1,0,0,0,0,0,0,0,1,0,1,0,0,0,0,0,0,1,0,0,4
0,0,0,0,0,0,0,2,2087,6,0,0,0,1,0,0,0,0,4,0,1,0,0,2,0,0,1,0,1,2,23,1,0,0,2,0,0,2,0,0,72
0,0,0,0,0,0,1,0,5,1132,0,0,0,0,0,0,0,0,1,1,1,0,1,0,0,0,0,0,0,1,5,0,0,0,0,1,2,2,0,0,34
0,13,5,1,0,0,0,0,0,0,1191,0,6,0,0,0,9,1,0,0,0,0,0,0,2,0,0,0,0,0,0,0,1,0,0,0,0,0,0,0,13
0,0,0,0,0,0,1,0,0,0,0,1408,0,0,0,0,0,0,0,0,1,0,1,0,0,0,0,10,1,0,0,0,0,0,0,0,1,0,0,0,25
0,1,1,0,0,1,0,0,0,0,2,0,752,0,0,0,6,1,0,0,0,0,0,0,0,0,0,0,0,0,0,0,0,0,0,0,0,0,0,0,13
0,0,0,0,0,0,1,0,1,1,0,1,0,890,0,1,0,0,0,0,0,0,0,0,0,0,2,0,3,0,6,2,0,0,0,2,0,1,0,0,9
0,0,0,0,0,0,1,0,4,0,0,0,0,1,860,0,0,0,3,13,0,0,0,0,0,0,0,1,0,0,3,0,0,0,1,0,0,0,0,0,18
0,0,0,0,0,0,2,0,0,3,0,0,0,1,0,708,0,0,0,0,1,0,2,0,0,0,2,3,0,0,6,0,0,0,0,1,2,0,0,0,18
2,9,161,1,0,1,0,0,0,0,7,0,3,0,0,0,2452,1,0,0,0,0,0,0,1,0,0,0,0,0,0,0,0,1,0,0,0,0,0,0,54
0,2,21,0,1,1,0,0,0,0,1,0,17,0,0,0,6,2580,0,0,0,0,0,0,0,0,0,0,0,0,0,0,0,4,0,0,0,0,0,0,37
0,0,0,0,0,0,0,1,1,0,0,1,0,0,0,0,0,0,264,0,0,0,0,0,0,0,0,0,0,0,1,0,0,0,0,0,0,0,0,0,5
0,0,0,0,0,0,0,0,1,0,0,0,0,0,4,0,0,0,0,2104,0,1,0,1,0,0,1,0,0,0,3,0,0,0,2,0,0,3,0,0,21
0,0,0,0,0,0,0,0,2,1,0,2,0,1,0,0,0,0,0,0,2718,2,1,0,0,0,1,0,0,0,1,0,0,0,1,1,0,1,0,0,27
0,0,0,0,0,0,2,0,1,1,0,1,0,1,0,0,0,0,0,0,0,1555,3,0,0,0,1,1,0,0,0,0,0,0,1,1,0,0,0,0,22
0,0,0,0,0,0,1,0,6,4,0,4,0,1,0,0,0,0,0,2,1,4,3077,4,0,0,1,1,0,0,10,0,0,0,0,1,2,0,0,0,73
0,0,0,0,0,0,0,0,0,0,0,0,0,0,0,0,0,0,0,0,0,1,0,375,0,0,0,0,0,0,0,0,0,0,0,0,0,0,0,0,7
2,0,1,7,0,1,0,0,0,0,0,0,0,0,0,0,2,0,0,0,0,0,0,0,593,0,0,0,0,0,0,0,1,0,0,0,0,0,0,0,5
0,0,2,5,0,0,0,0,0,0,0,0,0,0,0,0,1,0,0,0,0,0,0,0,4,275,0,0,0,0,0,0,0,0,0,0,0,0,0,0,5
0,0,0,0,0,0,4,0,0,0,0,0,0,4,0,0,0,0,0,2,1,1,0,0,0,0,1059,0,2,0,4,0,0,0,0,1,0,0,0,0,12
0,0,0,0,0,0,1,0,1,2,0,8,0,0,7,0,0,0,0,0,0,0,0,0,0,0,0,3307,1,0,1,0,0,0,1,2,0,1,0,0,45
0,0,0,0,0,0,1,0,0,0,0,1,0,1,0,0,0,0,0,1,1,0,0,1,0,0,0,0,2595,2,0,0,0,0,0,0,0,12,0,0,34
0,0,0,0,0,0,0,1,0,0,0,0,0,0,0,0,0,0,0,0,0,0,0,0,0,0,0,0,3,749,1,0,0,0,0,0,1,0,1,0,3
0,0,0,0,0,0,0,2,20,2,0,1,0,0,0,0,0,0,0,1,2,1,6,3,0,0,1,1,0,0,3446,0,0,0,1,0,0,6,0,0,50
0,0,0,0,0,0,0,0,0,2,0,0,0,0,0,0,0,0,0,0,0,0,0,0,0,0,0,0,1,0,1,214,0,0,0,0,1,0,0,0,4
0,0,2,1,0,0,0,0,0,0,1,0,0,0,0,0,2,0,0,0,0,0,0,0,0,0,0,0,0,0,0,0,187,0,0,0,0,0,0,0,4
1,1,4,1,0,0,0,0,0,0,0,0,1,0,0,0,1,1,0,0,0,0,0,0,5,0,0,0,0,0,0,0,0,1021,0,0,0,0,0,0,20
0,0,0,0,0,0,1,0,0,1,0,0,0,2,0,0,0,0,1,0,2,0,0,1,0,0,0,0,0,0,2,0,0,0,714,0,1,0,0,0,11
0,0,0,0,0,0,0,0,1,0,0,0,0,0,0,0,0,0,0,0,0,0,0,0,0,0,0,1,0,0,0,0,0,0,0,1224,2,0,0,0,13
0,0,0,0,0,0,0,0,1,1,0,0,0,0,0,3,0,0,0,0,0,0,0,0,0,0,0,0,0,0,1,0,0,0,0,0,766,0,0,0,18
0,0,0,0,0,0,0,0,0,1,0,0,0,0,0,0,0,0,0,0,1,0,0,0,0,0,0,1,4,0,1,0,0,0,0,0,0,1383,0,0,39
0,0,0,0,0,0,0,0,0,0,0,0,0,0,0,0,0,0,1,0,0,0,0,0,0,0,0,0,0,0,0,0,0,0,0,0,0,0,74,0,1
0,0,0,0,0,0,0,0,0,0,0,0,0,0,0,0,0,0,0,0,0,0,0,0,0,0,0,0,0,0,0,0,0,0,0,0,0,0,0,0,0
7,10,75,9,2,9,8,1,167,25,11,9,4,24,3,14,63,20,1,7,18,5,43,8,1,0,4,23,22,1,41,3,4,6,12,25,9,18,0,0,0
